#S#######################################
#           #   #   #   #     #   #     #
# # ### ##### # # # ### ### # # ####### #
# # # #       # # # # #           # #   #
### # # ####### ### # # ####### ### # # #
#   #     # # #         # # # #       # #
#######################################F#